+--+--+--+--+--+
|              |
+--+--+  +--+--+
|  *  *  *     |
+  +  +  +--+  +
|     *  *  *  |
+--+--+  +  +--+
|              g  
+--+--+--+--+--+