+--+--+--+--+--+
|              |
+  +  +--+  +  +
|              |
+  +--+  +--+  +
|              |
+--+  +--+  +  +
|              g  
+--+--+--+--+--+