+--*--**-+-**--+
|              |
+  *  +  +-*+  *
*     *  *     |
+  *--+  *--*  +
|     *     |  |
*  +--*--+  *  *
*              g  
+**+--*--*--*--+