+--+--+--+--+--+
|              |
+  +--+  +  +--+
|        *  *  |  
+--+--+  +  +  *
|        *  |  |
+  +--+--+  +  |
|     |        g  
+--+--+--+--+--+